z_ewrytqszqo	Streptopelia decaocto	Marco Dragonetti	www.birdsongs.it
z_rqmufdjeel	Streptopelia decaocto	Marco Dragonetti	www.birdsongs.it
z_xlkyozlfxr	Streptopelia decaocto	Marco Dragonetti	www.birdsongs.it
z_gjyvbpmohl	Streptopelia decaocto	Marco Dragonetti	www.birdsongs.it
z_kzlksktiob	Actitis hypoleucos	Marco Dragonetti	www.birdsongs.it
z_urrnifwrob	Actitis hypoleucos	Marco Dragonetti	www.birdsongs.it
z_nvptnbjkfu	Actitis hypoleucos	Marco Dragonetti	www.birdsongs.it
z_yhalaaekrg	Actitis hypoleucos	Marco Dragonetti	www.birdsongs.it
z_cmewqspftt	Actitis hypoleucos	Marco Dragonetti	www.birdsongs.it
z_ebrcrtgloq	Actitis hypoleucos	Marco Dragonetti	www.birdsongs.it
z_blzbssjvpn	Actitis hypoleucos	Marco Dragonetti	www.birdsongs.it
z_dpadrhadbd	Actitis hypoleucos	Marco Dragonetti	www.birdsongs.it
z_cqwdmsiukb	Actitis hypoleucos	Marco Dragonetti	www.birdsongs.it
z_dtxtmgcfbr	Anas crecca	Marco Dragonetti	www.birdsongs.it
z_yfktlkpkxo	Anas crecca	Marco Dragonetti	www.birdsongs.it
z_ovuszvqxsc	Anas crecca	Marco Dragonetti	www.birdsongs.it
z_cvarbgmxms	Anas crecca	Marco Dragonetti	www.birdsongs.it
z_ejfmydtfxc	Anas crecca	Marco Dragonetti	www.birdsongs.it
z_mjdgnrkmkl	Anas crecca	Marco Dragonetti	www.birdsongs.it
z_vhmsrnkymm	Anas crecca	Marco Dragonetti	www.birdsongs.it
z_zgqoanzsik	Anas crecca	Marco Dragonetti	www.birdsongs.it
z_plajvqsecf	Turdus philomelos	Marco Dragonetti	www.birdsongs.it
z_bqeedzibbx	Turdus philomelos	Marco Dragonetti	www.birdsongs.it
z_oanfsxqozk	Turdus philomelos	Marco Dragonetti	www.birdsongs.it
z_hhsltwvdcw	Turdus philomelos	Marco Dragonetti	www.birdsongs.it
z_dlaxecpljr	Turdus philomelos	Marco Dragonetti	www.birdsongs.it
z_fopixigirx	Turdus philomelos	Marco Dragonetti	www.birdsongs.it
z_royhlkphoh	Turdus philomelos	Marco Dragonetti	www.birdsongs.it
z_ihhrmtqojn	Turdus philomelos	Marco Dragonetti	www.birdsongs.it
z_wqvnytpdod	Turdus philomelos	Marco Dragonetti	www.birdsongs.it
z_pytlpdolnt	Gallinula chloropus	Marco Dragonetti	www.birdsongs.it
z_vudawtgdqd	Gallinula chloropus	Marco Dragonetti	www.birdsongs.it
z_wfmewknkvm	Gallinula chloropus	Marco Dragonetti	www.birdsongs.it
z_ijlyvtcnvb	Gallinula chloropus	Marco Dragonetti	www.birdsongs.it
z_xqoecemldh	Gallinula chloropus	Marco Dragonetti	www.birdsongs.it
z_sxqpiyolnz	Gallinula chloropus	Marco Dragonetti	www.birdsongs.it
z_eqbvpddbhk	Bubulcus ibis	Marco Dragonetti	www.birdsongs.it
z_jjmicaiucb	Bubulcus ibis	Marco Dragonetti	www.birdsongs.it
z_snhlaoprez	Asio otus	Marco Dragonetti	www.birdsongs.it
z_kuykiimblx	Asio otus	Marco Dragonetti	www.birdsongs.it
z_pkaqbgqcod	Asio otus	Marco Dragonetti	www.birdsongs.it
z_lewdakdauk	Asio otus	Marco Dragonetti	www.birdsongs.it
z_mfdhyyimui	Falco tinnunculus	Marco Dragonetti	www.birdsongs.it
z_qghwhqywds	Falco tinnunculus	Marco Dragonetti	www.birdsongs.it
z_ylujtyqxfq	Falco tinnunculus	Marco Dragonetti	www.birdsongs.it
z_zckjzpoyqz	Falco tinnunculus	Marco Dragonetti	www.birdsongs.it
z_mtvrvigrmd	Motacilla alba	Marco Dragonetti	www.birdsongs.it
z_ymzzxuoabu	Motacilla alba	Marco Dragonetti	www.birdsongs.it
z_itzkablemg	Motacilla alba	Marco Dragonetti	www.birdsongs.it
z_tvwzgylypg	Dendrocopos major	Marco Dragonetti	www.birdsongs.it
z_oedcvlnuee	Dendrocopos major	Marco Dragonetti	www.birdsongs.it
z_iizonajyxb	Dendrocopos major	Marco Dragonetti	www.birdsongs.it
z_fcahzbjgxk	Dendrocopos major	Marco Dragonetti	www.birdsongs.it
z_wbtaecdvbs	Dendrocopos major	Marco Dragonetti	www.birdsongs.it
z_lcrxknkato	Dendrocopos major	Marco Dragonetti	www.birdsongs.it
z_jjwroffnvz	Columba palumbus	Marco Dragonetti	www.birdsongs.it
z_gorfetzjku	Columba palumbus	Marco Dragonetti	www.birdsongs.it
z_eavlijjcup	Anas penelope	Marco Dragonetti	www.birdsongs.it
z_vzkcceupft	Anas penelope	Marco Dragonetti	www.birdsongs.it
z_gopghystjr	Oriolus oriolus	Marco Dragonetti	www.birdsongs.it
z_ucxnqiiftq	Oriolus oriolus	Marco Dragonetti	www.birdsongs.it
z_mgwzkqwztp	Oriolus oriolus	Marco Dragonetti	www.birdsongs.it
z_sczpgpxtiw	Oriolus oriolus	Marco Dragonetti	www.birdsongs.it
z_ajobhiwkdm	Oriolus oriolus	Marco Dragonetti	www.birdsongs.it
z_ljdwybdczp	Oriolus oriolus	Marco Dragonetti	www.birdsongs.it
z_ngrwvmkfrk	Oriolus oriolus	Marco Dragonetti	www.birdsongs.it
z_esmpsubjvl	Oriolus oriolus	Marco Dragonetti	www.birdsongs.it
z_hovewjmfds	Oriolus oriolus	Marco Dragonetti	www.birdsongs.it
z_qvmnggdpgi	Oriolus oriolus	Marco Dragonetti	www.birdsongs.it
z_helpmnafnp	Dryocopus martius	Marco Dragonetti	www.birdsongs.it
z_iwlzzyhrrs	Dryocopus martius	Marco Dragonetti	www.birdsongs.it
z_qboyrfyuqk	Dryocopus martius	Marco Dragonetti	www.birdsongs.it
z_vbqgkdvpog	Dryocopus martius	Marco Dragonetti	www.birdsongs.it
z_srwhzrkdju	Dryocopus martius	Marco Dragonetti	www.birdsongs.it
z_hvpdmjiviw	Dryocopus martius	Marco Dragonetti	www.birdsongs.it
z_xkfagsysqr	Dryocopus martius	Marco Dragonetti	www.birdsongs.it
z_xygeexcdkx	Dryocopus martius	Marco Dragonetti	www.birdsongs.it
z_yshhpomtug	Dryocopus martius	Marco Dragonetti	www.birdsongs.it
z_zcvfrqznqz	Dryocopus martius	Marco Dragonetti	www.birdsongs.it
z_ftfzhgcmyk	Dryocopus martius	Marco Dragonetti	www.birdsongs.it
z_mnqjcsambf	Dryocopus martius	Marco Dragonetti	www.birdsongs.it
z_dxishhzqtb	Alcedo atthis	Marco Dragonetti	www.birdsongs.it
z_wfkvmekigz	Alcedo atthis	Marco Dragonetti	www.birdsongs.it
z_zauuxdyahi	Alcedo atthis	Marco Dragonetti	www.birdsongs.it
z_mzijouakze	Alcedo atthis	Marco Dragonetti	www.birdsongs.it
z_xbyjqzglgx	Otus scops	Marco Dragonetti	www.birdsongs.it
z_urbeibutrc	Otus scops	Marco Dragonetti	www.birdsongs.it
z_ltiyjrmxok	Otus scops	Marco Dragonetti	www.birdsongs.it
z_nraqilfzev	Otus scops	Marco Dragonetti	www.birdsongs.it
z_uxwxgtdyue	Otus scops	Marco Dragonetti	www.birdsongs.it
z_tmhmpiytwn	Anas acuta	Marco Dragonetti	www.birdsongs.it
z_grokxjwkjv	Anas acuta	Marco Dragonetti	www.birdsongs.it
z_iggferevyk	Upupa epops	Marco Dragonetti	www.birdsongs.it
z_nloocwrynr	Upupa epops	Marco Dragonetti	www.birdsongs.it
z_oojfbpsrll	Pica pica	Marco Dragonetti	www.birdsongs.it
z_hrnplevldu	Pica pica	Marco Dragonetti	www.birdsongs.it
z_ovwdpmbyre	Pica pica	Marco Dragonetti	www.birdsongs.it
z_xpfgqxvjlp	Pica pica	Marco Dragonetti	www.birdsongs.it
z_ogrjawvwzh	Podiceps cristatus	Marco Dragonetti	www.birdsongs.it
z_wlgfgqikdj	Podiceps cristatus	Marco Dragonetti	www.birdsongs.it
z_utcmbolnsr	Podiceps cristatus	Marco Dragonetti	www.birdsongs.it
z_rxevoozdpe	Podiceps cristatus	Marco Dragonetti	www.birdsongs.it
z_enfuhujcaz	Podiceps cristatus	Marco Dragonetti	www.birdsongs.it
z_dxwhhxplyw	Podiceps cristatus	Marco Dragonetti	www.birdsongs.it
z_waotbiildz	Podiceps cristatus	Marco Dragonetti	www.birdsongs.it
z_lecauoamsj	Erithacus rubecula	Marco Dragonetti	www.birdsongs.it
z_rluzlmszoj	Erithacus rubecula	Marco Dragonetti	www.birdsongs.it
z_rzrapvuuls	Erithacus rubecula	Marco Dragonetti	www.birdsongs.it
z_gqfhschmbq	Erithacus rubecula	Marco Dragonetti	www.birdsongs.it
z_datzczqrsg	Erithacus rubecula	Marco Dragonetti	www.birdsongs.it
z_molfxigwjw	Erithacus rubecula	Marco Dragonetti	www.birdsongs.it
z_quyuytsohu	Erithacus rubecula	Marco Dragonetti	www.birdsongs.it
z_spuqjxthjf	Erithacus rubecula	Marco Dragonetti	www.birdsongs.it
z_pebhntxqcr	Erithacus rubecula	Marco Dragonetti	www.birdsongs.it
z_jwiwdeyqgh	Erithacus rubecula	Marco Dragonetti	www.birdsongs.it
z_loeuafydyo	Merops apiaster	Marco Dragonetti	www.birdsongs.it
z_ulkhyyfjya	Merops apiaster	Marco Dragonetti	www.birdsongs.it
z_qztmczlwlk	Merops apiaster	Marco Dragonetti	www.birdsongs.it
z_ewfpqdvxtd	Merops apiaster	Marco Dragonetti	www.birdsongs.it
z_owalhwkucl	Merops apiaster	Marco Dragonetti	www.birdsongs.it
z_vfjkxniahw	Merops apiaster	Marco Dragonetti	www.birdsongs.it
z_fnexbvogdm	Merops apiaster	Marco Dragonetti	www.birdsongs.it
z_cfdkzbihio	Merops apiaster	Marco Dragonetti	www.birdsongs.it
z_whjnxbizqp	Merops apiaster	Marco Dragonetti	www.birdsongs.it
z_uqhlfxouta	Athene noctua	Marco Dragonetti	www.birdsongs.it
z_aesjykkvdb	Athene noctua	Marco Dragonetti	www.birdsongs.it
z_ycsnxvzphf	Athene noctua	Marco Dragonetti	www.birdsongs.it
z_paomkvnoge	Athene noctua	Marco Dragonetti	www.birdsongs.it
z_ktkgpqhjyx	Athene noctua	Marco Dragonetti	www.birdsongs.it
z_gweglzixzk	Athene noctua	Marco Dragonetti	www.birdsongs.it
z_bbssjonetu	Athene noctua	Marco Dragonetti	www.birdsongs.it
z_rouijxrslt	Athene noctua	Marco Dragonetti	www.birdsongs.it
z_gsmmzhyfdr	Milvus milvus	Marco Dragonetti	www.birdsongs.it
z_tcdwsngxni	Milvus milvus	Marco Dragonetti	www.birdsongs.it
z_ktofibbuuk	Streptopelia turtur	Marco Dragonetti	www.birdsongs.it
z_mlpwguuavl	Streptopelia turtur	Marco Dragonetti	www.birdsongs.it
z_wvrdzedwoq	Streptopelia turtur	Marco Dragonetti	www.birdsongs.it
z_tqwlvghzkk	Vanellus vanellus	Marco Dragonetti	www.birdsongs.it
z_kwqdhbwuyi	Vanellus vanellus	Marco Dragonetti	www.birdsongs.it
z_sknqtvbtsc	Falco peregrinus	Marco Dragonetti	www.birdsongs.it
z_zrwqozhxzw	Falco peregrinus	Marco Dragonetti	www.birdsongs.it
z_npbqmawide	Falco peregrinus	Marco Dragonetti	www.birdsongs.it
z_sbvkzykkrb	Himantopus himantopus	Marco Dragonetti	www.birdsongs.it
z_skpvsodcwd	Himantopus himantopus	Marco Dragonetti	www.birdsongs.it
z_hsdfvefnwj	Himantopus himantopus	Marco Dragonetti	www.birdsongs.it
z_ntysxdqfmy	Himantopus himantopus	Marco Dragonetti	www.birdsongs.it
z_ijjpgvycug	Himantopus himantopus	Marco Dragonetti	www.birdsongs.it
z_ygujvibyvt	Himantopus himantopus	Marco Dragonetti	www.birdsongs.it
z_hgplnkafok	Himantopus himantopus	Marco Dragonetti	www.birdsongs.it
z_razwsjcxnz	Buteo buteo	Marco Dragonetti	www.birdsongs.it
z_dkdlwqhont	Buteo buteo	Marco Dragonetti	www.birdsongs.it
z_cwjramyagk	Circaetus gallicus	Marco Dragonetti	www.birdsongs.it
z_xfgknxnomf	Circaetus gallicus	Marco Dragonetti	www.birdsongs.it
z_rlmrhupppi	Circaetus gallicus	Marco Dragonetti	www.birdsongs.it
z_ygbyoxtdeh	Lanius senator	Marco Dragonetti	www.birdsongs.it
z_kkqrtitvon	Lanius senator	Marco Dragonetti	www.birdsongs.it
z_ilozzayryp	Anas querquedula	Marco Dragonetti	www.birdsongs.it
z_ulxcmiylum	Larus michahellis	Marco Dragonetti	www.birdsongs.it
z_cwiuucdhio	Larus michahellis	Marco Dragonetti	www.birdsongs.it
z_dgsvlunopp	Larus michahellis	Marco Dragonetti	www.birdsongs.it
z_dizfiwbyfj	Larus michahellis	Marco Dragonetti	www.birdsongs.it
z_iibmtbsrtj	Larus michahellis	Marco Dragonetti	www.birdsongs.it
z_scrcnilmoa	Larus michahellis	Marco Dragonetti	www.birdsongs.it
z_yfizipnuho	Nycticorax nycticorax	Marco Dragonetti	www.birdsongs.it
z_ypseflsjde	Nycticorax nycticorax	Marco Dragonetti	www.birdsongs.it
z_mcozovvewd	Nycticorax nycticorax	Marco Dragonetti	www.birdsongs.it
z_hlqeimwjfx	Nycticorax nycticorax	Marco Dragonetti	www.birdsongs.it
z_yvcsagqjpt	Circus aeruginosus	Marco Dragonetti	www.birdsongs.it
z_tmmyrixgwi	Circus aeruginosus	Marco Dragonetti	www.birdsongs.it
z_fzomnusvch	Turdus viscivorus	Marco Dragonetti	www.birdsongs.it
z_yaolnobjpe	Turdus viscivorus	Marco Dragonetti	www.birdsongs.it
z_bxndlyqymj	Turdus viscivorus	Marco Dragonetti	www.birdsongs.it
z_qatagolmbc	Turdus viscivorus	Marco Dragonetti	www.birdsongs.it
z_kvmidmfyxr	Egretta garzetta	Marco Dragonetti	www.birdsongs.it
z_veqdigbqir	Egretta garzetta	Marco Dragonetti	www.birdsongs.it
z_bwfojxgpfc	Egretta garzetta	Marco Dragonetti	www.birdsongs.it
z_wdovvryxjm	Egretta garzetta	Marco Dragonetti	www.birdsongs.it
z_eutzcezhit	Egretta garzetta	Marco Dragonetti	www.birdsongs.it
z_syoomyckcu	Egretta garzetta	Marco Dragonetti	www.birdsongs.it
z_viiygdzjgz	Ardea cinerea	Marco Dragonetti	www.birdsongs.it
z_hrzfmijiwa	Ardea cinerea	Marco Dragonetti	www.birdsongs.it
z_wvsfisqzgx	Anas platyrhynchos	Marco Dragonetti	www.birdsongs.it
z_envghsbnuu	Anas platyrhynchos	Marco Dragonetti	www.birdsongs.it
z_wstvrhxgce	Anas platyrhynchos	Marco Dragonetti	www.birdsongs.it
z_ebxcgibxqp	Anas platyrhynchos	Marco Dragonetti	www.birdsongs.it
z_ignipydqsf	Sturnus vulgaris	Marco Dragonetti	www.birdsongs.it
z_tztisshsve	Strix aluco	Marco Dragonetti	www.birdsongs.it
z_fgbdqbjbet	Strix aluco	Marco Dragonetti	www.birdsongs.it
z_xknvcndtds	Strix aluco	Marco Dragonetti	www.birdsongs.it
z_rtflcnoszw	Strix aluco	Marco Dragonetti	www.birdsongs.it
z_rbvexkriip	Strix aluco	Marco Dragonetti	www.birdsongs.it
z_fxrbwsczly	Strix aluco	Marco Dragonetti	www.birdsongs.it
z_qgwmaqzvyp	Strix aluco	Marco Dragonetti	www.birdsongs.it
z_ufxowdlqtk	Circus pygargus	Marco Dragonetti	www.birdsongs.it
z_mjcsypvpws	Circus pygargus	Marco Dragonetti	www.birdsongs.it
z_tsijfxbmkj	Circus pygargus	Marco Dragonetti	www.birdsongs.it
z_mxmqjcgflt	Botaurus stellaris	Marco Dragonetti	www.birdsongs.it
z_bamhmjmzmw	Anser anser	Marco Dragonetti	www.birdsongs.it
z_stncsjjcbm	Anser anser	Marco Dragonetti	www.birdsongs.it
z_mgnemxwfia	Anser anser	Marco Dragonetti	www.birdsongs.it
z_ydtirjwcrx	Anser anser	Marco Dragonetti	www.birdsongs.it
z_tivoyfudaq	Anser anser	Marco Dragonetti	www.birdsongs.it
z_ytdsvdfzjz	Anser anser	Marco Dragonetti	www.birdsongs.it
z_oklafhtpip	Tyto alba	Marco Dragonetti	www.birdsongs.it
z_ksvcwskyml	Tyto alba	Marco Dragonetti	www.birdsongs.it
z_jzwvklbipj	Tyto alba	Marco Dragonetti	www.birdsongs.it
z_otqucjvgcj	Tyto alba	Marco Dragonetti	www.birdsongs.it
z_nyxkzhzqgg	Tyto alba	Marco Dragonetti	www.birdsongs.it
z_fqahicofux	Burhinus oedicnemus	Marco Dragonetti	www.birdsongs.it
z_xhkoxrltwg	Burhinus oedicnemus	Marco Dragonetti	www.birdsongs.it
z_xxaahagouq	Burhinus oedicnemus	Marco Dragonetti	www.birdsongs.it
z_rvcqzoxswi	Burhinus oedicnemus	Marco Dragonetti	www.birdsongs.it
z_sfbwiranvf	Burhinus oedicnemus	Marco Dragonetti	www.birdsongs.it
z_ctotleimgk	Burhinus oedicnemus	Marco Dragonetti	www.birdsongs.it
z_hywzbjpfzh	Burhinus oedicnemus	Marco Dragonetti	www.birdsongs.it
z_djinrhmrrp	Burhinus oedicnemus	Marco Dragonetti	www.birdsongs.it
z_sblflvjcip	Burhinus oedicnemus	Marco Dragonetti	www.birdsongs.it
z_pvhflafrqc	Burhinus oedicnemus	Marco Dragonetti	www.birdsongs.it
z_rhalcsfclh	Burhinus oedicnemus	Marco Dragonetti	www.birdsongs.it
z_juxumzqzen	Burhinus oedicnemus	Marco Dragonetti	www.birdsongs.it
z_blnkjaefng	Burhinus oedicnemus	Marco Dragonetti	www.birdsongs.it
z_ifbvzhriky	Burhinus oedicnemus	Marco Dragonetti	www.birdsongs.it
z_oixaviwuck	Burhinus oedicnemus	Marco Dragonetti	www.birdsongs.it
z_wshquwndal	Burhinus oedicnemus	Marco Dragonetti	www.birdsongs.it
z_scjcjyzrnz	Burhinus oedicnemus	Marco Dragonetti	www.birdsongs.it
z_jatllckuia	Burhinus oedicnemus	Marco Dragonetti	www.birdsongs.it
z_exssuvlhhf	Burhinus oedicnemus	Marco Dragonetti	www.birdsongs.it
z_hdksbvudsa	Charadrius dubius	Marco Dragonetti	www.birdsongs.it
z_ymwalojzor	Charadrius dubius	Marco Dragonetti	www.birdsongs.it
z_fcmdweathu	Charadrius dubius	Marco Dragonetti	www.birdsongs.it
z_vzgsgaumer	Coturnix coturnix	Marco Dragonetti	www.birdsongs.it
z_rwvifyjbpy	Coturnix coturnix	Marco Dragonetti	www.birdsongs.it
z_lvblbomxhl	Fulica atra	Marco Dragonetti	www.birdsongs.it
z_mhwpsksgsv	Fulica atra	Marco Dragonetti	www.birdsongs.it
z_giigxuivxa	Fulica atra	Marco Dragonetti	www.birdsongs.it
z_agjormmuvu	Fulica atra	Marco Dragonetti	www.birdsongs.it
z_ttiuvuxqcy	Fulica atra	Marco Dragonetti	www.birdsongs.it
z_oommsezvxq	Fulica atra	Marco Dragonetti	www.birdsongs.it
z_sjxwyhhkno	Fulica atra	Marco Dragonetti	www.birdsongs.it
z_xefrkjuydt	Fulica atra	Marco Dragonetti	www.birdsongs.it
z_kdesjygdpx	Fulica atra	Marco Dragonetti	www.birdsongs.it
z_bbqzzmwkia	Ciconia ciconia	Marco Dragonetti	www.birdsongs.it
z_oghbwhtklm	Ciconia ciconia	Marco Dragonetti	www.birdsongs.it
z_eiksluhken	Phalacrocorax carbo	Marco Dragonetti	www.birdsongs.it
z_pqpfdwzkbb	Phalacrocorax carbo	Marco Dragonetti	www.birdsongs.it
z_jvldbymhik	Phalacrocorax carbo	Marco Dragonetti	www.birdsongs.it
z_ekvrpkeqvb	Dendrocopos minor	Marco Dragonetti	www.birdsongs.it
z_yxzpuwfqpe	Dendrocopos minor	Marco Dragonetti	www.birdsongs.it
z_xjxqnfoajc	Falco subbuteo	Marco Dragonetti	www.birdsongs.it
z_rbjrklumyu	Falco subbuteo	Marco Dragonetti	www.birdsongs.it
z_ylmkmqvaqv	Falco subbuteo	Marco Dragonetti	www.birdsongs.it
z_jinpdfyhnp	Falco subbuteo	Marco Dragonetti	www.birdsongs.it
z_bdfaomwdrj	Perdix perdix	Marco Dragonetti	www.birdsongs.it
z_ixfbdygrvf	Perdix perdix	Marco Dragonetti	www.birdsongs.it
z_ddnctzvznq	Gallinago gallinago	Marco Dragonetti	www.birdsongs.it
z_otgcngapxb	Gallinago gallinago	Marco Dragonetti	www.birdsongs.it
z_uaojyhyxxj	Gallinago gallinago	Marco Dragonetti	www.birdsongs.it
z_xwzxppsnum	Milvus migrans	Marco Dragonetti	www.birdsongs.it
z_ongsfmhrvw	Milvus migrans	Marco Dragonetti	www.birdsongs.it
z_emoqluwkku	Rallus aquaticus	Marco Dragonetti	www.birdsongs.it
z_pjsnialohe	Rallus aquaticus	Marco Dragonetti	www.birdsongs.it
z_frzhwbaepb	Rallus aquaticus	Marco Dragonetti	www.birdsongs.it
z_fcsjpvnzij	Turdus merula	Marco Dragonetti	www.birdsongs.it
z_fbicbbkhmq	Turdus merula	Marco Dragonetti	www.birdsongs.it
z_eqwlqzhbri	Turdus merula	Marco Dragonetti	www.birdsongs.it
z_uaumvlttac	Turdus merula	Marco Dragonetti	www.birdsongs.it
z_xqzhnfcxzv	Turdus merula	Marco Dragonetti	www.birdsongs.it
z_ywxojdyawl	Turdus merula	Marco Dragonetti	www.birdsongs.it
z_kucftonnqi	Turdus merula	Marco Dragonetti	www.birdsongs.it
z_jcxcqbboks	Turdus merula	Marco Dragonetti	www.birdsongs.it
z_vrobxzhxuu	Picus viridis	Marco Dragonetti	www.birdsongs.it
z_xfbllfjhon	Picus viridis	Marco Dragonetti	www.birdsongs.it
z_zgjyijwkna	Picus viridis	Marco Dragonetti	www.birdsongs.it
z_zlovkevgmn	Picus viridis	Marco Dragonetti	www.birdsongs.it
z_woyzigeqek	Picus viridis	Marco Dragonetti	www.birdsongs.it
z_izjkqgeybv	Picus viridis	Marco Dragonetti	www.birdsongs.it
z_gogwdrqipv	Picus viridis	Marco Dragonetti	www.birdsongs.it
z_krgksioyww	Picus viridis	Marco Dragonetti	www.birdsongs.it
z_xthvalweqp	Tachybaptus ruficollis	Marco Dragonetti	www.birdsongs.it
z_sfjejvftnk	Tachybaptus ruficollis	Marco Dragonetti	www.birdsongs.it
z_cskzwfihzp	Tachybaptus ruficollis	Marco Dragonetti	www.birdsongs.it
z_pezjxxuiuh	Tachybaptus ruficollis	Marco Dragonetti	www.birdsongs.it
z_ttqyhatwas	Phasianus colchicus	Marco Dragonetti	www.birdsongs.it
z_khyoqcuxkj	Phasianus colchicus	Marco Dragonetti	www.birdsongs.it
z_jauxsuuaty	Phasianus colchicus	Marco Dragonetti	www.birdsongs.it
z_xseeiwszwb	Phasianus colchicus	Marco Dragonetti	www.birdsongs.it
z_pjphulokks	Phasianus colchicus	Marco Dragonetti	www.birdsongs.it
z_zxpccmepzs	Phasianus colchicus	Marco Dragonetti	www.birdsongs.it
z_csntnaqqvb	Ardea purpurea	Marco Dragonetti	www.birdsongs.it
